HHHHH
HW  H
H BBH HHH
H B H HDH
HHH HHHDH
 HH    DH
 H   H  H
 H   HHHH
 HHHHH
